11111111
1P0C1111
11111111
100000E1
11111111