11111111111111
10010000000001
10000111110001
1P0011E0000001
100P0000000001
11111111111111
